level,d1Pos,d1,d2Pos,d2,left,right,enem,initX,initY,elPos,ele,minX,maxX
1,217,2,0,0,0,3,2,16,130,0,0,0,300
2,273,1,0,0,0,0,1,270,140,0,0,15,300
3,81,4,145,5,1,0,1,16,140,0,0,0,200
4,273,3,0,0,0,0,1,273,140,0,0,0,300
5,0,0,35,3,0,0,1,54,140,265,6,18,300
6,0,0,0,0,7,0,1,278,130,0,0,0,300
7,25,8,0,0,0,6,1,130,140,0,0,0,300
8,1,7,0,0,0,9,1,10,140,0,0,0,300
9,0,0,0,0,8,0,0,0,0,0,0,0,300
10,0,0,0,0,0,0,0,0,0,0,0,0,300
11,0,0,0,0,0,0,0,0,0,0,0,0,300