level,door1Pos,door1,door2Pos,door2,left,right,enemies,initialX,initialY,elevatorPos,elevator
1,217,2,0,0,0,3,1,16,130,0,0
2,273,1,0,0,0,16,160,0
3,81,4,145,5,1,0,1,16,160,0,0
4,273,0,0,0,0,273,160,0
5,35,3,0,0,0,0,1,54,160,273,6
6,0,0,0,0,7,0,1,278,130,0,0
7,25,8,0,0,0,6,1,130,160,0,0
8,1,7,0,0,0,9,1,10,160,0,0
9,0,0,0,0,8,0,0,0,0,0,0
10,0,0,0,0,0,0,0,0,0,0,0
11,0,0,0,0,0,0,0,0,0,0,0
