level,d1Pos,d1,d2Pos,d2,left,right,enem,initX,initY,elPos,ele,minX,maxX
1,205,2,0,0,0,3,0,16,130,0,0,0,300
2,266,1,0,0,0,0,1,270,140,0,0,15,300
3,61,4,134,5,1,0,2,16,140,0,0,0,200
4,273,3,0,0,0,0,1,273,140,0,0,0,300
5,0,0,18,3,0,0,2,54,140,265,6,18,300
6,0,0,0,0,7,0,2,268,130,0,0,0,300
7,10,8,212,10,0,6,1,280,140,0,0,0,300
8,1,7,0,0,0,9,0,10,140,0,0,0,300
9,0,0,0,0,8,0,0,10,140,0,0,0,300
10,263,11,5,7,0,0,0,10,140,0,0,0,300
11,0,0,0,0,0,0,2,10,140,0,0,0,300